,Node,Degree,In degree nodes,Out degree nodes,Betweenness centrality,Local reaching centrality,Label
0,1004956938924695731579548558351851673911287988149,2,1,1,1.9082512785283566e-05,0.0002917862497801517,Max > 86.0
1,1099677427812964779911440159251373005779951524872,13,13,0,0.0,0.0,Class 9
2,1006189408771502504044218322636032654929881206655,2,1,1,0.0005088670076075618,0.8979054058937259,Tot size <= 579.75
3,829650571075610833687368979855650942004633378987,9,4,5,0.010959723176347863,1.0834729678315445,rst_count <= 0.5
4,101264828074676163602647155244677239378950468880,11,5,6,0.018427346512988833,1.455959322526618,LLC <= 1.0
5,1195054242563020476783971172209845772931465202363,7,7,0,0.0,0.0,Class 4
6,1289412251196788795094901848766354122210942898917,9,9,0,0.0,0.0,Class 7
7,386179121541581531473808923745241541202203628799,9,4,5,0.029838689158588404,0.9935328045329836,Tot size > 60.03
8,73329605205328259845189764325143453556293602228,3,1,2,0.0013166933821845662,0.8525062675730861,Rate > 5465.58
9,884055746934093725632002180982242558654246584815,12,6,6,0.03808233468183091,1.477314496394205,Tot size <= 60.03
10,1013815938266333569731402817582638223921566304348,3,1,2,0.004083657736050683,0.6414720799273096,Max <= 280.0
11,1144928724640118816096967978210602438503999343321,2,1,1,0.0,0.00105772515545305,Tot size > 61.14
12,1195397662029115605699870660099171142982454886647,2,1,1,0.003383965600590286,0.7126277369573739,Tot size <= 61.14
13,1017464783939110745502635398393001332973811372193,3,1,2,0.007772943541205507,0.9479563641733533,Time_To_Live > 63.31
14,1145112842255972738991690543663517989526798005153,4,2,2,0.0024934483372770527,0.0006200457807828224,DNS > 0.0
15,500996362982295945551889270165951200065541244590,10,4,6,0.045146044831183375,1.029147187052922,DNS <= 0.0
16,1021220377266817481534173835958862579631154354895,9,2,7,0.02139149683230288,1.8985610591059265,ICMP <= 0.98
17,1248856849558564847560002556330070811675677986495,5,2,3,0.020834923542732108,2.6289057772042455,ack_count <= 55.0
18,1261298946907506760119401953925279134737640872426,2,1,1,1.9082512785283566e-05,0.0006200457807828224,Rate > 18039.74
19,381269691653681608369304349103036962138709404162,19,9,10,0.10689387578556345,1.4787641297701275,rst_flag_number <= 0.0
20,454348326995681653327348778569539340379197862131,2,1,1,0.0013739409205404168,0.007440549369393868,ack_count > 55.0
21,674196853837619115087533412010134527129516958514,106,53,53,0.40555428338803656,1.0032832065694084,IAT > 0.0
22,808678453879114279674903110893116058756852668722,3,1,2,0.012206447344986389,1.3975881146306164,UDP > 0.84
23,93160414772586774011403758180444851410804657224,5,2,3,0.038508510800702236,2.1777265925047544,UDP <= 0.84
24,1025520312540656970049943517486942098102090587070,2,1,1,1.2721675190189045e-05,0.0002917862497801517,DNS <= 0.05
25,1147257542945440298109815666246017244067397811172,11,11,0,0.0,0.0,Class 0
26,1027289454688117791059918992245738404991415369341,2,1,1,1.9082512785283566e-05,0.0002917862497801517,AVG <= 389.49
27,1037047602985921734368574115057047250451153813679,2,1,1,0.0,1.387331775488276,Rate > 42966.33
28,614032861654750103296117411198552944890594285401,5,3,2,0.008110067933745515,1.450105917975221,Rate > 33467.6
29,1039268936451367663632860312739660554909116889619,2,1,1,5.72475383558507e-05,0.000875358749340455,ack_count <= 3.5
30,971330983685549754196230402807555410292903783985,2,1,1,5.088670076075618e-05,0.0005835724995603034,Protocol Type <= 3.5
31,1039499528031335644987404234360822867072207772327,5,2,3,0.07345495254815154,0.9693909429328385,fin_flag_number <= 0.54
32,214995916160190136706412504492010041575692372956,3,1,2,0.013917512658066815,0.013785033217478156,Rate <= 3737.34
33,520760331373411551838147626966520151803640861425,5,2,3,0.05572729817062311,1.4870074306862067,syn_count <= 11.5
34,908313545598602039172458563952532818064593674489,4,2,2,0.07581482329593162,0.9792985470785135,Rate > 3737.34
35,1039903590463485290513532194946655834218216334516,2,1,1,0.0040645752232654,0.589929581798602,Header_Length <= 20.62
36,571014315486099811160209630909309362408532910489,2,1,1,0.004738824008345419,0.6432546439692164,Std <= 3.49
37,105039909723601567298536097835575645577882534044,3,1,2,0.008478996514261,0.003167096586155397,Time_To_Live > 63.8
38,372762278796559249877632480382100473167496266008,3,1,2,0.0042554003511182355,0.0013859846864557204,Variance <= 533797.88
39,431794188741397986685691306365407408003889847416,2,1,1,0.0014311884588962675,0.0005106259371152655,Variance > 533797.88
40,1054688692280153804303764117758189563712776011213,2,1,1,0.006055517390529985,1.2562867817119965,Rate > 29041.57
41,1398889516505027502475605639378806695948067153040,3,1,2,0.006729766175610005,1.286244957294445,Tot size <= 60.98
42,1056120656538915877111960409394232091480416622554,2,1,1,0.0,1.0904917258086186,Rate > 28393.76
43,1057537535189715354310856959156210325550869599847,2,1,1,0.0013866625957306058,0.0012400915615656447,Min > 198.0
44,1103501305157425962012665518775465767176663768243,2,1,1,1.9082512785283566e-05,0.0006200457807828224,Tot size <= 923.0
45,106709663811820763576994454957729977139718841937,6,3,3,0.008777955881230442,1.1455153694797737,AVG <= 60.03
46,1130495125353512581651048111023726367248747072485,2,1,1,3.180418797547261e-05,0.00036473281222518966,IPv <= 0.99
47,903278951719711971217088312706639570828323356369,2,1,1,0.00033076355494491514,0.9057634942491444,syn_count <= 44.5
48,1070455179483183994270690446636520772955216912365,2,1,1,0.01105513574027428,0.7649607756400347,Max <= 74.0
49,314427148528483189624902312985101437649740625682,2,1,1,0.011729384525354299,0.8498695078904732,Tot size <= 60.29
50,1071870735808846454999472532492334416933337872048,2,1,1,0.0,1.2972485730569605,Rate > 37024.76
51,677975171328005440332020652410698607492900844021,8,4,4,0.012753479378164517,1.2910592116429311,psh_flag_number <= 0.0
52,1078637391839043514471111813323355919949015392420,3,1,2,0.00826908887362288,0.7517726198654535,Header_Length > 4.28
53,716779015180965612852157089233286495740573426423,2,1,1,0.010240948528102181,0.7902257626726461,Std <= 9.51
54,848915693262154811100761154295876589077183318405,2,1,1,3.180418797547261e-05,0.0005106259371152655,Std > 9.51
55,1082852453109111908972567735148212235148475016291,3,1,2,0.012079230593084498,0.746124830637871,AVG <= 60.84
56,793047297679481078121793640411354090181283323941,2,1,1,1.9082512785283566e-05,0.0016048243737908344,fin_flag_number > 0.5
57,994474745895747528697522402354348123310041935247,2,1,1,0.011360455944838817,0.7610594083307609,fin_flag_number <= 0.5
58,1083685856254841466645548420770731337866316311497,6,3,3,0.03440577055186627,1.2016111612239477,syn_flag_number <= 1.0
59,647245696201680415484408757738089206177894229595,2,1,1,0.0,0.0031367021851366307,Rate > 12469.85
60,1084364300363438444210995209385625171839683897123,3,2,1,0.006144569116861309,0.8337404959481528,Rate > 15495.26
61,444903398511190255204347034984188376704789605296,7,4,3,0.03535989619113045,0.8645067618538308,syn_count <= 0.5
62,1092692924220173950435899201235462168683596532256,2,1,1,1.9082512785283566e-05,0.003793221247141972,fin_flag_number > 0.54
63,806200608638246844080666453603530564965483693516,6,6,0,0.0,0.0,Class 5
64,1093785806754185437076684056393050598263824105776,2,1,1,0.0013612192453502279,1.0646902119485662,HTTPS <= 0.12
65,1368814223599143039104592613935062139362013824735,2,1,1,0.002035468030430247,1.0429182418257756,Tot size <= 61.01
66,1094943304957963099499113933824461680139699896189,2,1,1,0.001399384270920795,0.0005835724995603034,Max > 72.0
67,1095371933177199582857395126378295794126304582053,2,1,1,0.0,0.0004376793746702275,Variance <= 11.72
68,1450449059843239801921012223270599716006843930105,13,13,0,0.0,0.0,Class 14
69,1097685971244050831008591183153001501282396416595,3,1,2,0.00017810345266264664,0.006182221167216964,Tot sum <= 74218.5
70,1173524053277695952050228447585155293715168649365,3,1,2,0.00012721675190189045,0.002844915935356479,AVG > 288.35
71,58167617336195089195158436581908193979510521948,2,1,1,3.180418797547261e-05,0.00036473281222518966,AVG <= 288.35
72,1099837601190882094153890155034126924744497196015,3,1,2,0.01377121339337964,0.00613723745370919,Rate <= 4232.01
73,1316449520207143807505543960884893927552355903565,3,1,2,0.006939673816248124,0.0029178624978015173,Header_Length > 15.8
74,251106073466452331847616825908323423761756017796,2,1,1,0.004153626949596723,0.0018935711834691094,Header_Length <= 15.8
75,11024183441238561031646045784932940052587263639,2,1,1,0.00606187822812508,0.558489753809531,ICMP > 0.0
76,1147185253849198402071456934462675553138540938169,2,1,1,0.006736127013205099,0.616152332425047,Variance <= 2.12
77,166159182996065465535329370594107080027780897492,6,6,0,0.0,0.0,Class 17
78,1103979316193807681621553680570349860310020838131,2,1,1,0.0020418288680253416,1.0517739081508397,ack_count > 28.5
79,1105899047644727027690076175906427874195436356824,2,1,1,0.00012721675190189045,1.0369369393394472,Rate <= 12469.85
80,1110160009113663470232737792819033192274591739707,2,1,1,3.180418797547261e-05,0.0002917862497801517,ICMP > 0.49
81,150913633418211931633209064051558675044205003315,2,2,0,0.0,0.0,Class 3
82,1113895344376847430104826160459310938643558043712,2,1,1,0.004045492710480116,1.1719595518969692,ARP <= 0.03
83,1124376468236507240799748785484258569542740730940,2,1,1,0.0026969951403200774,0.0014589312489007586,Max <= 1053.0
84,1458046072508084738017532533536297217474493312790,2,1,1,0.0013103325445894716,0.0007294656244503793,Tot size > 582.39
85,1125873403287923370432866384827688847971189640350,2,1,1,0.0,1.0301709459279134,Header_Length > 19.94
86,1127762964095799008211414835116037806894122652514,2,1,1,0.0020163855176449637,0.9434042294995957,Time_To_Live <= 65.59
87,139269823756540673252801909832932435138868614447,7,7,0,0.0,0.0,Class 12
88,1131619772951663121177085378924280864716930714667,2,1,1,0.002754242678675928,0.000984778593008012,rst_flag_number > 0.04
89,616153043118471924456922405283436188305841804300,2,1,1,0.0013930234333257004,0.0006565190620053413,Tot sum <= 6044.0
90,1132148281313616335396874722515768869436744630921,5,2,3,0.03191232221458922,1.3378350123310225,syn_flag_number > 0.47
91,808150994519957143823626071398236360997032162215,7,4,3,0.03821591227132789,1.292432537895778,HTTPS <= 0.16
92,1133005285223757995936455739739517633272097926073,2,1,1,0.007391293285499835,0.8425443218072454,Rate > 15927.71
93,1438533490077616860002617715863456121341977708798,3,2,1,0.008090985420960232,0.9189064652825891,Rate > 11236.51
94,1136480345837051966606882443681739710320630451803,2,1,1,0.0,0.0067110837449434885,Tot sum <= 50165.5
95,928621589127927934620961952074257259595278295629,7,7,0,0.0,0.0,Class 2
96,1137617360340785425424206571423729440200272012686,6,3,3,0.03509274101213648,1.196773215871443,syn_flag_number <= 0.47
97,305707579109274393908164410737594628215284948707,8,8,0,0.0,0.0,Class 8
98,960857184356715293545776069782630727612998063589,2,1,1,0.035537999643793096,0.6941673969958734,Rate <= 7383.63
99,503190330350616711249264568626062576856455685617,2,1,1,0.007410375798285119,0.6925792505754619,Rate <= 51496.94
100,1147214408579205035010053549250827833846607578555,2,1,1,0.008090985420960232,0.8353661250985924,Rate > 11247.35
101,740389177849121768943570866346437897654140555459,7,3,4,0.017428695010558992,0.8940221905433983,HTTP <= 0.5
102,114774472760180458990838230941351827606165336366,3,1,2,0.008211841335267029,0.003793221247141972,Time_To_Live <= 73.14
103,1360423709631032153541519319318959260715615373316,2,1,1,0.001412105946110984,0.0005835724995603034,Tot sum <= 57593.5
104,658004361260031743335864266206637354233880291048,2,1,1,0.004070936060860494,0.0021883968733511375,Tot sum > 57593.5
105,1148374734560588385688644899927068439511312820095,2,1,1,0.0001144950767117014,0.0030807764872621012,ack_count > 3.5
106,504810142463691955945989001396358974168500148020,2,1,1,0.00012721675190189045,0.002553129685576327,ack_count <= 29.5
107,1154635305504849212151675598793268169318364080006,2,1,1,6.360837595094522e-06,0.0004012060934477086,Header_Length > 30.8
108,586132518360797208519456527676709771770114101842,2,1,1,3.816502557056713e-05,0.0009118320305629739,Max > 585.0
109,901432241489695114333182747417294426177077295921,2,1,1,3.816502557056713e-05,0.0005106259371152655,Max <= 585.0
110,1179841346540361629442226287764495914393642805482,2,1,1,0.002022746355240058,1.1890872425138934,Header_Length <= 8.04
111,1185500427075983885710384266543734172589399922438,2,1,1,0.0013166933821845662,0.00032825953100267067,Std <= 102.99
112,118576753643825033586125637769324768359501434455,2,1,1,0.011404981808004479,0.7762353350084221,Rate > 34242.01
113,1186966968020633937560817720275266992097871202631,2,1,1,1.9082512785283566e-05,0.003793221247141972,rst_flag_number > 0.64
114,1188069166886931517161630189315691135989504584715,3,1,2,0.004083657736050683,1.1200394266891192,Rate <= 34242.01
115,1247226560879476554718867574257026037171450094467,2,1,1,0.0033776047629951915,1.1001270012830522,rst_flag_number <= 0.61
116,1354628499782302630032091556530877797151908706938,2,1,1,6.360837595094522e-06,0.0021154503109061,rst_flag_number > 0.61
117,1191265939451470139362218590667782673402136128427,2,1,1,0.0,0.683675113979136,Rate > 18576.94
118,966407136946709909257105274902543005852367257971,3,2,1,0.002060911380810625,0.7533499625800736,Rate <= 20616.32
119,1193479894222333494663825363137800920700380152400,3,1,2,0.0020863547311910035,0.697686659276021,UDP <= 0.96
120,204347204281742868701996312022320582814519172393,3,1,2,0.0001399384270920795,0.0047628026396406,Protocol Type <= 32.0
121,355283096002457121760332550158282231126662837533,6,2,4,0.010489021194310867,0.7532678765437105,Protocol Type > 32.0
122,637392211167955937447731520936041203621602725310,2,1,1,0.004058214385670306,0.8157519435549596,HTTPS <= 0.01
123,1200212656161414303228774150193157753759092491448,2,1,1,0.0041981528127623844,0.0007659389056728982,Time_To_Live <= 103.5
124,343222646122407906122176884284221420683220394485,2,1,1,0.002811490217031779,0.0005106259371152655,syn_flag_number <= 0.01
125,1200846720303325213342149199885547224637469463757,2,1,1,3.180418797547261e-05,0.00032825953100267067,psh_flag_number <= 0.15
126,1203929309401051775858260926867423463390142066359,2,1,1,8.269088873622878e-05,0.00032825953100267067,TCP <= 0.98
127,1210871206543296477824000561613338992636452192365,5,2,3,0.0708470091341628,1.3725624130965584,syn_flag_number > 0.98
128,130658331587065144646767045055249360349697823887,4,2,2,0.014394575477698904,0.7263612208456274,HTTP > 0.0
129,1423884053544544831305111053615062014391660550592,5,2,3,0.06187186728748442,1.4329339736914994,syn_count > 10.0
130,976590010995392964794827738075171663902001551192,10,5,5,0.08671729893392362,1.344886526575731,HTTP <= 0.0
131,1211779019603258000957243660708019163554054981716,2,1,1,0.009840215759611226,0.005349414579302782,IAT <= 0.01
132,1212503759933804690935309758539749420489738910351,3,1,2,5.088670076075618e-05,1.8260440041116788,Tot sum <= 6023.0
133,1212648030699905606729209989386013922983880011404,4,2,2,0.01809022212044882,0.887373810536843,Tot sum > 6019.0
134,300278194402074849108479059468873765755103825622,3,1,2,0.009617586443782918,0.00790862314508286,ICMP <= 0.63
135,1215839813877299233964846928498023745689282539309,2,1,1,0.006717044500419816,0.7820468416385236,Rate > 16115.11
136,121802481147560775077299624181338910261968970414,2,1,1,0.006080960740910363,0.959562686240424,Variance <= 7.72
137,1221930062397130117475468795135534893111850560907,3,1,2,0.0020481897056204364,0.7120707289803332,Tot size > 337.28
138,623285390860722186724098851061072781541050231532,4,2,2,0.001412105946110984,0.0023342899982412135,UDP > 0.69
139,842045391598478050991573233800853374302860972684,5,2,3,0.023436506119125768,0.7546793056352703,UDP <= 0.69
140,1222186079463890095135259690959922920390529956030,3,1,2,0.00020354680304302472,0.968661196947114,AVG <= 333.43
141,1283991082173772016518065909568524892283508500682,10,5,5,0.05481769839452459,0.8702223164160454,HTTPS <= 0.0
142,437680220140810113287834500747221149964041219778,4,2,2,0.0014311884588962675,0.0011671449991206067,HTTPS > 0.0
143,1222601964312497184889374675037247127730971076459,2,1,1,1.9082512785283566e-05,0.0004376793746702275,AVG > 60.05
144,1226936458496643174234053145305772947428944617410,2,0,2,0.0,1.8970798974256995,TCP <= 0.14
145,1447396986048769513394311495645860512783216508489,3,1,2,6.996921354603975e-05,1.5351180557067485,Tot size <= 337.28
146,1228483095333527985450516757820500893444665514216,2,1,1,0.0098720199475867,0.6930007222344721,HTTPS > 0.65
147,786349574425021217130345420177624513899385040289,4,2,2,0.014439101340864565,0.8014544891772846,syn_count > 50.0
148,1229389734763399693554433963997394989217779871077,3,1,2,0.01226369488334224,0.837510708202797,Std <= 7.9
149,606399140813896131815403088258641479210423761008,2,1,1,0.014210111187441163,0.9200618196820456,UDP > 0.99
150,884140696176403427856940610791604337069240474597,2,1,1,1.2721675190189045e-05,0.0004376793746702275,UDP <= 0.99
151,1232700188292272324596334779946034774796540001101,2,1,1,0.0062145383304073485,0.7348565366017277,Header_Length <= 8.12
152,1233827628424075745650871837449583826131696847230,2,1,1,1.2721675190189045e-05,0.000948305311785493,Rate <= 21273.6
153,124194953432050239659634754601535415706623029866,2,1,1,1.9082512785283566e-05,0.0005106259371152655,Min > 51.5
154,1242273841778362708336921402096432079545834620454,2,1,1,0.0013135129633870188,0.0004376793746702275,Variance <= 92195.93
155,211416935876627775340659220458446348809437318389,2,1,1,0.0040518535480752104,1.065802585639891,Header_Length > 12.48
156,321087464509897612155678518476529618237722110509,3,1,2,0.021451924789456275,0.7074884075003095,Tot sum > 40449.5
157,660072533567118862595710070382829879384609683276,4,2,2,0.002557056713227998,0.004085007496922124,Rate > 21069.62
158,986705454089452939888289196530829091844843156763,5,2,3,0.04563582932600565,1.9818966311897572,Tot sum <= 40449.5
159,1250607048608459486461826077552866092857082632028,2,1,1,0.05173269216090375,0.7051004269069095,rst_flag_number <= 0.54
160,1265463884429046888607070228311510892729642829777,2,1,1,0.05240694094598377,0.8112845976711023,Time_To_Live <= 64.96
161,1251283219811142930637563099697256871847602802339,2,1,1,1.2721675190189045e-05,0.00025531296855763275,Time_To_Live <= 98.56
162,1038436899229500694985337865675868909331337187676,9,9,0,0.0,0.0,Class 13
163,1253765307863100382728853774365475283976134988916,2,1,1,3.816502557056713e-05,0.00032825953100267067,ack_count > 50.5
164,1254510886311821051714432777686648994024869082055,2,1,1,8.269088873622878e-05,0.0006565190620053413,Rate <= 11507.96
165,1268411593268232483430428365547346850983874902416,4,2,2,0.006736127013205099,0.8387492850072193,syn_count <= 99.5
166,273098554375013574546895676285734938795296916003,2,1,1,0.005406711955830344,0.8402566069128135,Header_Length <= 19.84
167,1277994235947803578329944679888528435207843157188,2,1,1,7.633005114113426e-05,1.2492363465586276,Tot size <= 60.22
168,639025992518995640837875136019703437249644650736,10,5,5,0.01133501259445844,1.1794705235652005,ICMP <= 0.0
169,1293435375969281418416064147128945185471955154918,2,1,1,0.002811490217031779,0.0010941984366755688,ack_count > 6.5
170,159838416105582533402330908581193333100390537098,2,1,1,0.0014311884588962675,0.0007294656244503793,Time_To_Live > 115.9
171,1294618747895839912051157923351947215329979346304,2,1,1,1.2721675190189045e-05,0.000875358749340455,UDP > 0.35
172,1298811500292761668641905648017441642128882448032,2,1,1,0.004217235325547668,0.972924376716326,Tot size <= 95.84
173,918149077080394414364391691868538557652969577587,5,2,3,0.012804366078925274,1.0179363745269754,Time_To_Live > 63.94
174,1301717828426602954288603137271699630700637141912,2,1,1,3.180418797547261e-05,0.0002917862497801517,AVG > 487.39
175,1305324431410831595874502209181366416707759968391,2,1,1,6.360837595094522e-06,0.0002917862497801517,HTTP <= 0.3
176,766600899218658470523299855266318768212653745934,2,1,1,0.0096366689565682,0.82932533609463,Time_To_Live <= 64.88
177,1316156716093976565410678609037156675505252238723,2,1,1,1.2721675190189045e-05,0.001021251874230531,Max <= 580.0
178,289948339653008642686555210996221958324152260388,2,1,1,0.0014311884588962675,0.0005835724995603034,TCP > 0.97
179,813062565650150951257102283744626030487453733533,2,1,1,0.0027796860290563064,0.0015318778113457964,TCP <= 0.97
180,1316460251752025237613009313760354682148374829127,2,1,1,0.002029107192835153,1.27919391171567,Rate <= 28393.76
181,131987145794919036028769967188509879077719423043,2,1,1,1.2721675190189045e-05,0.003793221247141972,fin_count > 47.0
182,1323047930991308041765475788196428779254874921224,2,1,1,0.002035468030430247,0.9881882550315055,syn_flag_number > 0.97
183,1324371470327791779098880434634111243200462776602,4,2,2,0.009439482991120272,1.1199959533125812,ack_count <= 0.5
184,466969404269064599390429714309854206895740096146,2,1,1,0.0,1.0786106703397906,Rate > 23033.61
185,1338816312518188475962343076177654263658148398540,4,2,2,0.0,0.007477022650616387,Rate > 22204.0
186,29161254730628893339886509661238234785262585488,3,2,1,0.0,0.004267373903034719,Time_To_Live > 63.68
187,1342711528011078160341251481821037894703430789133,2,1,1,0.0013612192453502279,0.865690096635968,Max > 65.0
188,1347307571678372314489892669073252048172585324382,2,1,1,0.018494135307737324,0.9117423642221762,AVG <= 60.14
189,1349071513295700278748187051052441012589401909299,2,1,1,0.0013612192453502279,1.2503594865277579,Variance <= 0.5
190,253073028212269479547431695579629254221260745352,2,1,1,0.002035468030430247,1.1627428232656836,UDP <= 1.0
191,1352050020656262741693322719307907244184626549068,2,1,1,6.360837595094522e-06,0.00032825953100267067,Header_Length > 8.04
192,1352871866413527095523914073126370447437933151239,2,1,1,0.005413072793425439,0.7140926034645831,Header_Length <= 20.04
193,208383359490288337047245524447795172020483962956,2,1,1,0.006087321578505458,0.8170206932006948,syn_flag_number > 0.99
194,1355750221540452617130497636759529301053809752660,2,1,1,0.0018446429025774115,0.6988656970587198,Rate <= 36563.06
195,1408244053465729695881615478380056601795487668647,2,1,1,3.180418797547261e-05,0.0002917862497801517,Header_Length <= 1.08
196,13672438437480729858458241021168197286188959470,2,1,1,0.001437549296491362,0.0005835724995603034,AVG <= 732.36
197,875925742556499296198174157734249046758240151473,2,1,1,6.360837595094523e-05,0.0002917862497801517,Std > 12.4
198,1373978435636655411124723487779251878890918019164,3,1,2,0.016181970841920464,1.2181182069597785,syn_count <= 10.0
199,1376473038043658780615051571311440708071146955986,2,1,1,0.002029107192835153,0.8030259237378089,Rate > 17754.04
200,1394414938751630133600879251490207247212425569527,4,2,2,0.012677149327023383,0.8883274534195404,ack_count > 1.5
201,149625616446505712822840410992696059165445778286,2,1,1,0.0026270259267740376,0.0005106259371152655,syn_count <= 97.5
202,629457562640147371009644160886266079271713146440,2,1,1,0.0060109915273643235,1.3555591079980285,AVG <= 60.05
203,1400726506543363978769886136469311192676644306699,2,1,1,0.013478614864005293,1.0197906581588216,Rate > 18948.66
204,717769742043123468129139495734517837611664784776,4,2,2,0.014152863649085311,1.1336620432758338,Rate > 7383.63
205,1407752399691753111195256374318124716710643237404,2,1,1,0.00014629926468717402,0.0013130381240106827,Tot size > 323.2
206,986401027314626581266846179287292339229493571101,2,1,1,0.00012085591430679593,0.000984778593008012,Time_To_Live <= 164.5
207,979349037987607136696014248748093468021266506181,5,5,0,0.0,0.0,Class 16
208,141170005109097147632783388267009512650502852416,3,0,3,0.0,3.0047599362038335,Max <= 505.5
209,354681054264715384335398050755444867472917748791,5,2,3,0.016449126020914435,2.602226808087827,TCP > 0.13
210,421462125778769096091307625085087521635724868105,3,1,2,0.00012721675190189045,1.5019185246639533,TCP <= 0.13
211,1420748483413313840337754892043498790930339844122,9,0,9,0.0,1.4287425969393748,TCP > 0.14
212,351719838132079246673137711173414664727990693919,6,3,3,0.002060911380810625,1.4206288524121609,IPv <= 1.0
213,398141873949452840099074031234268363300046019535,3,1,2,6.996921354603975e-05,1.086108247267354,ack_flag_number > 0.61
214,547394607757499222173676927817295885278532339826,9,2,7,0.0060682390657201745,1.4461737963545769,ack_flag_number <= 0.61
215,691312149885111651874004367225852377389637222299,2,1,1,0.0,0.7913680294404809,Rate > 20616.32
216,1423075027383231498511160085501386333427388769232,3,1,2,0.006996921354603974,0.0015318778113457964,Header_Length <= 23.6
217,314185085669582645289694451612614254647861159772,2,1,1,3.816502557056713e-05,0.00025531296855763275,Time_To_Live > 103.5
218,562046793467200678581015677606765918518282347171,5,2,3,0.055383812940488004,1.6328909413695762,AVG <= 64.17
219,652585741328743398264862673785724724110563685880,2,1,1,0.00579472304913111,0.6826918402617994,syn_flag_number <= 0.98
220,1424931659590415544028789491918633679981534123708,2,1,1,0.0033712439254000967,1.2652428622656804,Min <= 198.0
221,1429736733055924487782339034982066677284513234,3,1,2,0.016417321832938963,0.008167583441762745,AVG > 64.17
222,633490463420534897358199048681827370111968526669,2,1,1,0.005533928707732234,0.0018236640611259479,Time_To_Live > 73.14
223,1431250096593308799321048232025024073009796724591,3,1,2,0.0054575986565911,1.3233240836895852,Rate <= 29041.57
224,1433363699261665036197240347030372349592561206638,2,1,1,0.0028687377553876297,0.9216732097340673,AVG <= 60.17
225,205074892978992233397178715472094422003421219119,2,1,1,0.003542986540467649,0.9433263275590602,Max <= 160.0
226,1434977815706127752802690983917599399729310002312,2,1,1,0.006519858534971885,0.7507752342464978,Min <= 585.0
227,594519936504744430976618450822657096924847281446,2,1,1,0.008765234206040251,1.0022300064651728,Rate <= 23033.61
228,618147995084667987135175647456151147334506637332,2,1,1,6.360837595094522e-06,0.00703934327594616,ICMP > 0.64
229,943823048786762193759314282692962038706387187964,3,1,2,0.0021563239447370433,1.370127619856537,ICMP <= 0.64
230,1447448078405003318031937942688752824553279876028,2,1,1,0.017819886522657303,0.8248970993379553,Variance > 0.5
231,1451450749261996240994018083692480148411077067700,3,1,2,0.0027351601658906445,1.1808324156534797,Header_Length > 3.96
232,367872830698449002838137098385702580984760359472,2,1,1,0.0013803017581355114,0.0005106259371152655,Header_Length <= 7.96
233,622507920463769779075865916477008611069526760946,4,2,2,0.0040518535480752104,1.1236681289841814,Header_Length > 7.96
234,1453124241820930137593817582455775169724448410692,2,1,1,0.0,0.0012036182803431257,Tot size <= 925.83
235,966392641167187058724046781217470361435945267299,5,5,0,0.0,0.0,Class 15
236,149491667790248576528541286858391295016024269135,4,2,2,0.006831539577131517,1.6422847141388772,Tot sum > 5095.5
237,215383433681511305412443950155583652632701317434,5,2,3,0.017365086634608045,1.698810280702192,Header_Length > 12.7
238,308748111080942547549440645300437083853460789174,4,2,2,0.005463959494186195,1.5629990536878098,fin_count <= 47.0
239,393007019062016252811637323603804738481208892990,2,1,1,0.0012594458438287153,0.00025531296855763275,syn_flag_number <= 0.94
240,401681225980513833816511303711321747154197223740,2,1,1,3.816502557056713e-05,0.00036473281222518966,Tot sum <= 4935.5
241,160040534423514285241529851913511837104462288827,2,1,1,0.00817367630969646,0.002750693292198305,Header_Length <= 22.8
242,471914371409134240828464093176419169591549222705,3,1,2,0.006831539577131517,0.0015318778113457964,IAT <= 0.02
243,161752755988431012676687805114387695416407561678,2,1,1,0.0060682390657201745,0.9142679823160357,AVG <= 60.39
244,980658980292015349005067119544853893079516545374,4,2,2,0.008777955881230442,1.0153335838516355,Rate <= 22204.0
245,170490873092759560770984717977244053574989379077,2,1,1,0.0027415210034857393,0.8846246748531533,syn_count > 98.5
246,802260351619285619499789804189387567413124900725,3,1,2,0.0034157697885657586,0.865570105924934,Variance <= 549.14
247,182469980542636291533740477312637194834494933527,2,1,1,0.0,1.0913579662376536,Variance <= 364.5
248,184362444209595229937451507393572897456165518137,2,1,1,0.0013166933821845662,0.00032825953100267067,HTTPS > 0.12
249,1200488665683979084540564030318004407378857238121,3,3,0,0.0,0.0,Class 19
250,189632594456630107758302908508590165679314344702,2,1,1,0.000632903340711905,0.00036473281222518966,Rate > 13921.37
251,1274488445781065893627356834134748731753597895145,6,6,0,0.0,0.0,Class 6
252,195932165075812882531548154722223208744019516454,2,1,1,0.0002544335038037809,0.0067086521928619875,AVG <= 650.5
253,613148910390529016751623441696139971801492582077,4,2,2,0.012607180113477343,0.007056972028537044,psh_flag_number <= 0.45
254,202047716375941863549702669988722540027983163840,3,1,2,0.0074389995674630435,1.3134352635498705,AVG <= 63.45
255,866230897052383425851097187327856331057467844436,3,1,2,0.00802419662621174,0.9504654419939021,rst_count > 0.5
256,202981891873177368164176333223234410753748648850,3,2,1,0.0001144950767117014,0.001021251874230531,AVG > 650.5
257,208797973962340694904605892894863341665156159963,2,1,1,0.03055110296923899,0.8093126321108851,ARP <= 0.0
258,548457630762247645813412579056652155648214399551,2,1,1,0.009681194819733863,0.003336089455819734,HTTPS <= 0.55
259,825772407670504315594556767788188293322909939823,3,1,2,0.0016220135867491031,0.007584879353660122,HTTPS > 0.55
260,866362377888693633348857042612027846300371293791,5,2,3,0.018726305879958275,1.4551687389926673,HTTPS <= 0.65
261,215572767540421144518074419808146100703954764822,1,0,1,0.0,1.4031043203058626,ack_count > 34.5
262,996365505953360352583302409149965296489281185287,2,1,1,0.0020481897056204364,1.4223979939987745,Std <= 309.49
263,219904519481270089928148710292985698660002954063,2,1,1,0.0027733251914612116,0.000875358749340455,Std > 102.99
264,525033459985603071059454004586368716056114286579,2,1,1,0.001399384270920795,0.0005835724995603034,Min > 57.0
265,223721085390018671471507340469200417035843576279,2,1,1,1.9082512785283566e-05,0.0004012060934477086,Min > 585.0
266,227447326667630553155226896688686987708762198585,2,1,1,0.008345418924764014,0.0025829161985747185,AVG <= 275.65
267,246789808074662392377807714021915398408811577217,2,1,1,0.0,1.3139867096737163,Rate <= 42966.33
268,371591821625166726613853158278384607871803201524,4,2,2,0.0029387069689336695,0.0019573994256085175,fin_count <= 0.5
269,252010141222363675975229682751303990200333624189,2,1,1,6.360837595094522e-06,0.00025531296855763275,Rate <= 18576.94
270,253027903146484083465585881027710119359787970411,2,1,1,0.024406533852377683,0.7534328529508465,Tot sum <= 6040.5
271,255754884937074542786808684770018395466989087366,3,1,2,6.360837595094522e-06,1.0679366808090933,ICMP > 0.98
272,271360791041329513121713886045076389681180180936,2,1,1,0.0012594458438287153,0.0004741526558927465,Header_Length <= 22.14
273,285848756680663301328249263588796850659393704237,2,1,1,3.180418797547261e-05,0.000948305311785493,syn_flag_number <= 0.0
274,288917878638231178829796272300511307740034885598,2,1,1,0.0016283744243441977,1.0333720483135294,ack_flag_number <= 0.01
275,402867858760991954844664844285930748874071650701,2,1,1,0.0023026232094242173,1.1433477682152626,Rate <= 37024.76
276,497397108425041817113625580328269114205293182954,2,1,1,5.088670076075618e-05,0.0002917862497801517,AVG > 60.43
277,290054243710762425484253731432724798032647298596,2,1,1,3.180418797547261e-05,0.00036473281222518966,TCP <= 0.02
278,556814550987292010398533907836759971119323896994,3,1,2,0.00552756787013714,0.003720274684696934,Tot sum <= 7862.0
279,739048105039316845556678977750949840117242246597,2,1,1,0.0013866625957306058,0.00175071749868091,Tot sum > 7862.0
280,307701714342322827697145174236435344645894427990,2,0,2,0.0,1.1237582750529482,ack_count > 55.5
281,628565321790908284416473685908453330117936187826,4,2,2,0.0026333867643691324,0.0013495114052332017,AVG > 60.03
282,30955050729353174576964217616068263650661544531,2,1,1,0.0013930234333257004,0.001896610623570986,Variance <= 310.12
283,313483202383182042238332054728754821161102223753,2,1,1,0.001412105946110984,0.00025531296855763275,TCP > 0.25
284,501655186152747800769250387318330733123068864739,1,1,0,0.0,0.0,Class 22
285,318488381547225258869765356212449730786344128770,2,1,1,0.01151947688471618,0.8135264655123655,Rate > 56335.6
286,320036019410955464970256625878882836932836302749,2,1,1,0.0,1.1295998539312415,Rate > 13056.13
287,323365331359883618955872639391120300394768816116,2,1,1,3.180418797547261e-05,0.0004376793746702275,Rate <= 39153.56
288,326619458612308634943804262106290861560677383248,3,1,2,0.0027224384907004557,1.0554179002775623,TCP > 0.98
289,330423003016799333295295360856202842822515227095,2,1,1,0.0004961453324173727,0.8319562702263307,Rate <= 56335.6
290,651771731677652606474281604941474028660589499691,6,3,3,0.008765234206040251,0.8803615358551019,TCP <= 1.0
291,335160010246241548673459658302412570746236332675,2,1,1,0.0,0.00105772515545305,Rate > 8442.89
292,337549320964340042971864334741544409655746795523,2,1,1,0.001399384270920795,0.0005835724995603034,Variance > 310.12
293,341772470312571041379463915770825944345196331357,2,1,1,0.002766964353866117,0.000875358749340455,ICMP <= 0.02
294,354020877576780028507017220151498099457879008298,2,0,2,0.0,0.6891538484722461,Max > 505.5
295,385820742898683827677298701792602949694545004003,2,1,1,1.2721675190189045e-05,0.002042503748461062,UDP > 0.96
296,916684113466444293014517521564481237723568887564,5,2,3,0.022288374933211206,2.2054407934867477,Rate > 4232.01
297,995229568255667035478440078140295732741585669517,2,1,1,0.0,0.0007659389056728982,Tot size > 579.75
298,36357636010807514807763507059367238897363392571,5,2,3,0.032522962623718295,1.4369463854824238,Time_To_Live <= 65.48
299,397774439371521148991861944053126582211209263475,2,1,1,5.088670076075618e-05,1.6483785396825408,syn_flag_number > 0.08
300,614832850651495905739691309542084861393230740191,5,2,3,0.028140345520698166,1.8663873621146463,rst_flag_number <= 0.92
301,723238409586932247474156438906287377419644156318,4,2,2,0.035493473780627435,1.2808930862615737,syn_flag_number <= 0.08
302,947109982503932386922828481338684096656887611191,2,1,1,1.2721675190189045e-05,0.00025531296855763275,Rate > 21363.85
303,369094136181861511456984378782333414919954546840,3,1,2,0.0020545505432155308,1.6873175518599348,TCP > 0.15
304,41610184734847801728814268205255037641149571982,3,1,2,3.816502557056713e-05,1.5701082579952772,syn_flag_number <= 0.12
305,796508954304138736335668361930572879393343556038,3,1,2,0.0040645752232654,1.46216233789728,syn_flag_number > 0.12
306,370439297831369004036492644282123532033270578164,2,1,1,0.0012467241686385264,0.0004741526558927465,Tot sum <= 58241.0
307,913947650662979053585443862439365087155174156046,2,1,1,0.0014693534844668348,0.0012765648427881635,HTTPS > 0.23
308,372747345808224598058527899038074409198017650958,2,1,1,0.002681093046332341,0.000875358749340455,AVG > 333.43
309,687545124913071081137977338635752012142793181669,2,1,1,0.001424827621301173,0.0005835724995603034,Header_Length <= 30.8
310,383218782771357978585169052685700553136836321049,13,5,8,0.020650459252474367,1.1453030079597288,HTTPS <= 0.5
311,524283168405501983686383612325514398692543450709,7,3,4,0.02389766684477012,1.3191064306321667,Rate <= 33467.6
312,870371993257664071544545483056995616552888782029,6,4,2,0.019922143347836044,1.4771478620213438,rst_flag_number <= 0.04
313,969886296342304719619032070060724549679822874889,6,3,3,0.017113833549601814,1.490373216482765,syn_count > 99.5
314,64003991419077514829670779264866669882056000302,5,3,2,0.012047426405109026,1.5427496468924753,ack_flag_number <= 0.0
315,812154287432014736192004779977695362718979437348,2,1,1,0.0029768719945042366,0.806232076015926,Rate > 5495.13
316,784784111356022649392592673994476324076361800325,2,1,1,0.0013548584077551333,0.9448344828770953,ICMP <= 0.51
317,790876424267650571181104124750940381135677990025,2,1,1,0.0013421367325649443,0.00025531296855763275,ICMP > 0.51
318,387587405642621519745509255499974046560031130251,2,1,1,0.00015902093987736306,0.0016412976550133533,syn_flag_number <= 0.05
319,392411771682679707527492238297144199619242557498,3,1,2,0.012708953514998856,0.7919861985085044,rst_flag_number <= 0.1
320,395649438639594802002772977043986714864292952724,3,1,2,0.0,0.939831024587898,Header_Length > 19.9
321,668059660509619966113261850778110689590250177401,2,1,1,0.00012085591430679593,0.0055910934879748525,ack_count <= 28.5
322,403432429061805736849763962718543799166150163915,2,1,1,0.0014057451085158895,0.0006565190620053413,Time_To_Live > 65.48
323,412324963114429216303121420797538085038231597248,2,1,1,6.360837595094522e-06,0.003720274684696934,psh_flag_number > 0.31
324,920891343264642955875723140970687654508614581210,3,1,2,0.0020418288680253416,1.468496105532497,rst_flag_number <= 0.64
325,418144457840964304497992011456889548580623451202,2,1,1,0.000632903340711905,0.00036473281222518966,HTTPS > 0.5
326,418307462120432800510061265950867296024208128564,2,1,1,1.9082512785283566e-05,0.00025531296855763275,Std > 881.08
327,536379450475556072184587862136549103768089111707,3,1,2,0.0021563239447370433,1.3425563390684823,UDP > 0.21
328,576469401334307038641541727330207299673152882989,2,1,1,6.360837595094522e-06,0.006966396713501122,UDP <= 0.21
329,424425215640969577163759483224571765655162423253,2,1,1,0.013612192453502278,0.008717114212182032,Header_Length > 22.8
330,427046742202049927730729926930208044493271444064,2,1,1,0.0,0.8083679973051048,Rate <= 13056.13
331,430676193277948048120546330160335145025834045250,2,1,1,0.006045976134137343,0.8914460955815481,Max <= 524.0
332,436078146173065326522366906946701643161421863101,2,1,1,3.180418797547261e-05,0.000948305311785493,Rate > 39153.56
333,436213302420197388478926100817058769049608782567,3,1,2,0.004096379411240873,0.9076522536171948,Rate <= 21069.62
334,700582927224985273960231097232026982196681841557,2,1,1,0.0013803017581355114,0.0005106259371152655,Time_To_Live > 65.59
335,441608687898520007627750495604227555834959497186,3,1,2,0.005495763682161667,0.0016777709362358721,Tot sum <= 6137.0
336,922011842173420598622370025406938927306959366619,2,1,1,6.360837595094522e-06,0.00025531296855763275,ICMP > 0.02
337,974917724565762924147239408850273035998941217083,2,1,1,0.0,0.006638137182498451,Tot size <= 499.82
338,445655515400453454336099265520396193195822978090,4,2,2,0.006042795715339796,0.9161564654752263,Rate <= 22348.42
339,450732185867019503557253938593748687470332854114,2,1,1,0.00016538177747245757,0.004414048598236706,fin_flag_number <= 0.05
340,535107755774645169446021304629942138765230757309,3,1,2,0.00019718596544793018,0.002771969372911441,Std > 6.54
341,459095922493968805637085670176116730580141633671,3,1,2,0.00012085591430679593,2.1652393828139713,TCP <= 0.15
342,944422542289125127041015257983608939661341112801,3,1,2,0.0021944889703076104,0.8692072352434624,Tot sum > 6023.0
343,469429346844521226243511547060999824770995960034,2,1,1,0.005393990280640155,0.8420358671301856,Rate > 13475.7
344,473953263320851994686343342962300907554521726644,4,1,3,0.006087321578505458,1.3378505113500592,Rate > 34698.19
345,488174752153584712838486246964092536174804766629,2,1,1,0.004179070299977101,0.0014589312489007586,TCP > 0.65
346,490635285905637089394642792958999322696128276281,2,1,1,0.006764750782383025,1.5079150037389684,syn_count > 11.5
347,997615451808318503393351029089410391822613267018,2,1,1,0.0013739409205404168,0.0014589312489007586,Tot sum > 6137.0
348,783113453102667112731188575197170560868800941739,2,1,1,0.008084624583365138,0.8033626705232159,Std > 0.5
349,508973760624302540351923961908288627214425665661,2,1,1,0.005413072793425439,1.3521830914432784,UDP <= 0.0
350,511317468713443631647685672855745088127936741964,2,1,1,0.0,0.0064192974951633374,Header_Length <= 3.96
351,864864200643226849701765533847206404990151510088,5,2,3,0.05320204564537059,1.5804362932006004,TCP > 0.08
352,995612475677072736573222583012576702317849187829,2,1,1,0.003250388011093301,0.6993047582501064,psh_flag_number > 0.0
353,529474059872292147360827741109641522519335637985,2,1,1,0.005196804315192225,1.0487525405898164,AVG <= 60.09
354,691374065139725964810631865490857177508773788566,2,1,1,0.005871053100272244,1.0368717479544736,Std <= 7.87
355,535014403990421357927105505505142713061922261974,2,1,1,0.0011894766302826757,0.0002917862497801517,Header_Length <= 19.94
356,853227177762817013136390902807935883483167767771,2,1,1,0.00015902093987736306,0.001969557186016024,UDP <= 0.05
357,92796053454621314014308896411770301676111327719,2,1,1,2.544335038037809e-05,0.0004012060934477086,UDP > 0.05
358,898719365062298142130297246889715994846980640795,5,2,3,0.009484008854285932,1.2671118735990496,Tot sum <= 6019.0
359,880490751589871964538542668688292328002819763730,2,1,1,1.2721675190189045e-05,0.0004376793746702275,Rate <= 15495.26
360,551029189400271216945454177312211001602992597430,2,1,1,0.012107854362262423,0.8525841389292972,Rate > 3143.75
361,580455367232524417050864310411464991081256623013,2,1,1,1.9082512785283566e-05,0.00032825953100267067,ack_count <= 19.5
362,663185189900093265755930090734422286982064066159,2,1,1,1.9082512785283566e-05,0.0004376793746702275,Rate <= 585.45
363,624903607105051613905377777177287995443074023903,2,1,1,0.007979670763046079,1.259958336999788,Variance <= 23.79
364,633502282401005350026747508235965803730936095583,4,2,2,3.816502557056713e-05,1.2403670206440716,Rate > 22348.42
365,644079923757209704725724745466476431209882854847,2,1,1,0.0012976108693992826,0.0036473281222518957,rst_flag_number > 0.92
366,646042172806530868953788785690390781190734563866,2,1,1,0.0,1.1754901191635465,Tot sum <= 6007.0
367,837317828089854147792073741927704512063623612642,3,1,2,0.0064689718342111294,0.7428845229480441,DNS <= 0.02
368,732729296198829811421009722595792705108755137930,2,1,1,0.0,0.0038661678095870096,Rate > 19266.89
369,741344365272659446420402462637171697161549898359,2,1,1,0.0,1.561486799317067,Max <= 65.0
370,797838806140117609216346393341079242189341532900,2,1,1,0.0,0.0033555418724717442,psh_flag_number > 0.51
371,815761067129329308102348206004812793500655207340,2,1,1,0.0012403633310434318,0.0004376793746702275,Rate > 61110.65
372,848549046274181459752920171456949353655765056629,4,2,2,0.007264076533597945,0.8521404038523038,psh_flag_number <= 0.51
373,95735174449033790078617514426568653591252752573,3,1,2,0.0027224384907004557,0.7441386187577135,Rate <= 19266.89
374,990905233488702449871163001595435005326089922107,2,1,1,0.0,0.0037567479659194533,syn_flag_number <= 0.5
375,674589925038746597802488478293282037039744721770,2,1,1,0.00279876854184159,0.000875358749340455,Rate <= 3143.75
376,684120374691895951831155392573552270469021141862,2,1,1,1.9082512785283566e-05,0.00025531296855763275,syn_count <= 86.5
377,691833964926903158584042717923172871277992366910,2,1,1,6.0427957153397965e-05,0.004048534215699604,Max > 524.0
378,995339536146353925649923187500133951183459949517,2,1,1,4.770628196320892e-05,0.0026990228104664033,Tot size <= 596.6
379,737638280483053466145703982728663190654440353291,3,1,2,0.00272879932829555,1.287318084048007,Time_To_Live > 50.18
380,747710591094129847084801789450391590543939496565,2,1,1,0.00392463679617332,0.8078131749939594,Tot size > 61.33
381,78537823699966272517312222361752741086290132614,2,1,1,0.03621224842887311,0.8041590038299075,AVG <= 60.25
382,789760083673379718669293976721395669031145825367,2,1,1,5.088670076075618e-05,0.0005835724995603034,Tot sum > 74218.5
383,791333349202962983985736445281380552371407895508,2,1,1,0.007305421977966059,1.0828279318797442,syn_count > 86.5
384,903686791002075791747963941599117647730749730449,2,1,1,0.0014057451085158895,0.001021251874230531,Time_To_Live > 86.05
385,946919246056588936601771494237035620459520760185,2,1,1,9.541256392641784e-05,0.0004741526558927465,AVG > 562.93
386,837350019345797083069017098769523350833973862102,5,2,3,0.0,1.450265905776485,ack_count <= 1.5
387,850596377973968096728544387816433225428737403666,2,1,1,0.004147266112001629,0.719832418336681,Tot size > 60.22
388,852465153168939677569694617208756442982126097171,2,1,1,6.360837595094522e-06,0.0007294656244503793,Rate > 9148.04
389,857572863444058291183728997605570761983628243389,2,1,1,2.226293158283083e-05,0.0013495114052332017,Header_Length <= 8.92
390,876410876357386860631673563927773441962768076227,4,0,4,0.0,3.2450587182853465,ack_count <= 55.5
391,886117993711265310330841906045280010867938997873,2,1,1,0.0,0.8363269439575497,Rate <= 17754.04
392,88668373598538322758045852686233882722738098926,2,0,2,0.0,2.669673439905295,ack_count <= 34.5
393,891175772418703270195019381891160387965774936342,3,1,2,0.004083657736050683,0.8334515948058132,UDP > 0.56
394,941278637030543447859351251723037049681201808628,3,1,2,0.024063048622242577,1.332933621120817,TCP <= 0.08
395,996460644680000395293605201263120423837822298342,3,1,2,0.00020990764063811925,0.011112193012460775,UDP <= 0.56
396,967040336672553238170009365789307922968592337744,2,1,1,0.012034704729918836,0.7755795218428573,Header_Length <= 20.24
397,977255016329647810331315504923836660223756440732,2,1,1,0.0,0.9599040874784518,Rate <= 15927.71
